1111111111111
10010000001C1
1100000000001
1P0C0000E00C1
1111111111111
