1111111111111
10M00000000C1
1000011111001
1PEC11C0000M1
1111111111111
